2 2 2 2 2 2 2 2 2 2 2 2 2 2 2 2 2 2 2 2
2 2 2 2 2 24 17 17 17 17 17 17 17 17 24 2 2 2 2 2
2 2 2 24 24 4 4 4 4 4 4 4 4 4 4 24 24 2 2 2
2 2 4 4 4 4 4 4 4 4 4 4 4 4 4 4 4 4 2 2
2 4 4 4 4 4 24 18 24 24 18 22 24 18 24 4 4 4 4 2
2 4 4 4 25 4 4 4 4 4 4 4 4 4 4 4 4 4 4 2
2 4 4 4 18 4 4 4 4 4 4 4 4 4 4 4 4 4 4 2
2 4 4 4 18 4 4 4 4 24 22 24 4 4 4 4 4 4 4 4
2 4 4 4 18 4 4 4 4 24 24 25 4 4 4 4 4 4 4 2
2 4 4 4 18 4 4 4 4 4 4 4 4 4 4 4 4 4 4 2
2 4 4 4 22 4 4 4 4 4 4 4 4 4 4 4 4 4 4 2
2 2 4 4 4 4 4 4 4 4 4 4 4 4 4 4 4 4 2 2
2 2 2 24 24 4 4 4 4 4 4 4 4 4 4 24 24 2 2 2
2 2 2 2 2 24 17 17 17 17 17 17 17 17 24 2 2 2 2 2
2 2 2 2 2 2 2 2 2 2 2 2 2 2 2 2 2 2 2 2