5 5 4 1 0 0 3 6 6 6 6 6 6 3 0 0 1 4 5 5
5 5 4 1 0 0 0 3 6 6 6 6 3 0 0 0 1 4 5 5
5 5 4 1 0 7 0 3 6 6 6 6 3 0 7 0 1 4 5 5
5 5 4 1 7 0 3 3 6 6 6 6 3 3 0 7 1 4 5 5
5 5 4 1 0 3 3 3 6 6 6 6 3 3 3 0 1 4 5 5
5 5 4 6 3 3 3 3 6 6 6 6 3 3 3 3 6 4 5 5
5 5 4 6 6 6 6 6 6 6 6 6 6 6 6 6 6 4 5 5
5 5 4 6 6 6 6 6 6 6 6 6 6 6 6 6 6 4 5 5
5 5 4 6 6 6 6 6 6 6 6 6 6 6 6 6 6 4 5 5
5 5 4 6 3 3 3 3 6 6 6 6 3 3 3 3 6 4 5 5
5 5 4 1 0 3 3 3 6 6 6 6 3 3 3 0 1 4 5 5
5 5 4 1 7 0 3 3 6 6 6 6 3 3 0 7 1 4 5 5
5 5 4 1 0 7 0 3 6 6 6 6 3 0 7 0 1 4 5 5
5 5 4 1 0 0 3 6 6 6 6 6 6 3 0 0 1 4 5 5
5 5 4 1 0 0 3 6 6 6 6 6 6 3 0 0 1 4 5 5