2 2 2 2 2 2 2 2 2 2 2 2 2 2 2 2 2 2 2 2
2 24 24 17 17 17 17 17 17 24 24 37 37 37 37 37 37 24 24 2
2 38 38 38 38 38 38 38 38 38 38 38 38 38 38 38 38 38 38 2
2 38 38 38 38 38 38 38 38 38 38 38 38 38 38 38 38 38 38 2
2 38 38 35 38 16 38 38 38 18 18 38 38 38 16 38 35 38 38 2
2 38 38 35 38 15 38 38 38 18 18 38 38 38 15 38 35 38 38 2
2 38 38 35 38 15 38 38 38 18 18 38 38 38 15 38 35 38 38 2
2 38 38 35 38 15 38 38 38 18 18 38 38 38 15 38 35 38 38 2
2 38 38 35 38 15 38 38 38 38 38 38 38 38 15 38 35 38 38 2
2 38 38 35 38 15 38 38 38 38 38 38 38 38 15 38 35 38 38 2
2 38 38 35 38 14 38 38 38 38 38 38 38 38 14 38 35 38 38 2
2 38 38 38 38 38 38 38 38 38 38 38 38 38 38 38 38 38 38 2
2 38 38 38 38 38 38 38 38 38 38 38 38 38 38 38 38 38 38 2
2 24 24 19 19 19 19 19 19 24 24 19 19 19 19 19 19 24 24 2
2 2 2 2 2 2 2 2 2 2 2 2 2 2 2 2 2 2 2 2