2 2 2 2 2 2 2 2 2 2 2 2 2 2 2 2 2 2 2 2
2 2 2 2 2 19 19 19 19 19 19 19 19 19 19 2 2 2 2 2
2 2 2 19 19 4 4 4 4 4 4 4 4 4 4 19 19 2 2 2
2 2 4 4 4 4 11 12 12 12 12 12 12 13 4 4 4 4 2 2
2 4 4 4 16 4 4 4 4 4 4 4 4 4 4 16 4 4 4 2
2 4 4 4 15 4 4 4 4 4 4 4 4 4 4 15 4 4 4 2
2 4 4 4 15 4 4 4 24 24 24 24 4 4 4 15 4 4 4 2
2 4 4 4 15 4 4 4 24 24 24 24 4 4 4 15 4 4 4 4
2 4 4 4 15 4 4 4 24 24 24 24 4 4 4 14 4 4 4 2
2 4 4 4 15 4 4 4 4 4 4 4 4 4 4 4 4 4 4 2
2 4 4 4 14 4 4 4 4 4 4 4 4 4 4 4 4 4 4 2
2 2 4 4 4 4 4 4 4 4 4 4 4 4 4 4 4 4 2 2
2 2 2 19 19 4 4 4 4 4 4 4 4 4 4 19 19 2 2 2
2 2 2 2 2 19 19 19 19 19 19 19 19 19 19 2 2 2 2 2
2 2 2 2 2 2 2 2 2 2 2 2 2 2 2 2 2 2 2 2