0 0 0 0 0 0 0 0 0 0 0 0 0 0 0 0 0 0 0 0 0 0 0 0 0 0 0 0 0 0 0 0 0 0 0 0 0 0 0 0 0 0 0 0 0 0 0 0 0 0 29 29 29 26 28 5 28 27 29 29
0 0 0 0 0 0 0 0 0 0 0 0 0 0 0 0 0 0 0 0 0 0 0 0 0 0 0 0 0 0 0 0 0 0 0 0 0 0 0 0 0 0 0 0 0 0 0 0 0 0 29 29 29 26 28 5 28 27 29 29
0 0 0 0 0 0 0 0 0 0 0 0 0 0 0 0 0 0 0 0 0 0 0 0 0 0 0 0 0 0 0 0 0 0 0 0 0 0 0 0 0 0 0 0 0 0 0 0 0 0 29 29 29 26 28 5 28 27 29 29
0 0 0 0 0 0 0 0 0 0 0 0 0 0 0 0 0 0 0 0 0 0 0 0 0 0 0 0 0 0 0 0 0 0 0 0 0 0 0 0 0 0 0 0 0 0 0 0 0 0 29 29 29 26 28 5 28 27 29 29
0 0 0 0 0 0 0 0 0 0 0 0 0 0 0 0 0 0 0 0 0 0 0 0 0 0 0 0 0 0 0 0 0 0 0 0 0 0 0 0 0 0 0 0 0 0 0 0 0 0 29 29 29 26 28 5 28 27 29 29
0 0 0 0 0 0 0 0 0 0 0 0 0 0 0 0 0 0 0 0 0 0 0 0 0 0 0 0 0 0 0 0 0 0 0 0 0 0 0 0 0 0 0 0 0 0 0 0 0 0 29 29 29 26 28 5 28 27 29 29
0 0 0 0 0 0 0 0 0 0 0 0 0 0 0 0 0 0 0 0 0 0 0 0 0 0 0 0 0 0 0 0 0 0 0 0 0 0 0 0 0 0 0 0 0 0 0 0 0 0 29 29 29 26 28 5 28 27 29 29
0 0 0 0 0 0 0 0 0 0 0 0 0 0 0 0 0 0 0 0 0 0 0 0 0 0 0 0 0 0 0 0 0 0 0 0 0 0 0 0 0 0 0 0 0 0 0 0 0 0 29 29 29 26 28 5 28 27 29 29
0 0 0 0 0 0 0 0 0 0 0 0 0 0 0 0 0 0 0 0 0 0 0 0 0 0 0 0 0 0 0 0 0 0 0 0 0 0 0 0 0 0 0 0 0 0 0 0 0 0 29 29 29 26 28 5 28 27 29 29
0 0 0 0 0 0 0 0 0 0 51 51 51 51 51 51 51 51 51 51 51 51 51 51 51 51 51 51 51 51 51 51 51 51 51 51 51 51 0 0 0 0 0 0 0 0 0 0 0 0 29 29 29 26 28 5 28 27 29 29
0 0 0 0 0 0 0 0 0 0 51 52 46 46 46 46 46 46 46 46 46 46 46 52 52 50 50 50 50 50 50 50 50 50 50 50 52 51 0 0 0 0 0 0 0 0 0 0 0 0 29 29 29 26 28 5 28 27 29 29
0 0 0 0 0 0 0 0 0 0 51 52 36 36 36 36 36 36 36 36 36 36 36 36 36 36 36 36 36 36 36 36 36 36 36 36 52 51 0 0 0 0 0 0 0 0 0 0 0 0 29 29 29 26 28 5 28 27 29 29
0 0 0 0 0 0 0 0 0 0 51 36 36 36 36 36 36 36 36 36 36 36 36 36 36 36 36 36 36 36 36 36 36 36 36 36 36 51 0 0 0 0 0 0 0 0 0 0 0 0 29 29 29 26 28 5 28 27 29 29
0 0 0 0 0 0 0 0 0 0 51 36 36 36 36 36 36 36 52 52 52 36 36 36 36 36 36 36 36 36 36 36 36 36 36 36 36 36 0 0 0 0 0 0 0 0 0 0 0 0 29 29 29 26 28 5 28 27 29 29
0 0 0 0 0 0 0 0 0 0 51 36 36 36 36 36 36 36 43 52 43 36 36 36 36 36 36 36 36 36 36 36 36 36 36 36 36 36 0 0 0 0 0 0 0 0 0 0 0 0 29 29 29 26 28 5 28 27 29 29
0 0 0 0 0 0 0 0 0 0 51 36 36 36 36 36 36 36 44 52 44 36 36 36 36 36 36 36 36 36 36 36 36 36 36 36 36 36 0 0 0 0 0 0 0 0 0 0 0 0 29 29 29 26 28 5 28 27 29 29
0 0 0 0 0 0 0 0 0 0 51 36 36 36 36 36 36 36 45 52 45 36 36 36 36 36 36 36 36 36 36 36 36 36 36 36 36 36 0 0 0 0 0 0 0 0 0 0 0 0 29 29 29 26 28 5 28 27 29 29
0 0 0 0 0 0 0 0 0 0 51 36 36 52 48 48 48 48 52 52 52 48 48 48 48 52 36 36 36 36 36 36 36 36 36 36 36 51 0 0 0 0 0 0 0 0 0 0 0 0 29 29 29 26 28 5 28 27 29 29
0 0 0 0 0 0 0 0 0 0 51 36 36 52 52 52 52 52 52 52 52 52 52 52 52 52 36 36 36 36 36 36 36 36 36 36 36 51 0 0 0 0 0 0 0 0 0 0 0 0 29 29 29 26 28 5 28 27 29 29
0 0 0 0 0 0 0 0 0 0 51 36 36 52 48 48 48 48 52 52 52 48 48 48 48 52 36 36 36 36 36 36 36 36 36 36 36 51 0 0 0 0 0 0 0 0 0 0 0 0 29 29 29 26 28 5 28 27 29 29
0 0 0 0 0 0 0 0 0 0 51 36 36 36 36 36 36 36 43 52 43 36 36 36 36 36 36 36 36 36 36 36 36 36 36 36 36 51 0 0 0 0 0 0 0 0 0 0 0 0 29 29 29 26 28 5 28 27 29 29
0 0 0 0 0 0 0 0 0 0 51 36 36 36 36 36 36 36 44 52 44 36 36 36 36 36 36 36 36 36 36 36 36 36 36 36 36 51 51 51 36 36 36 51 51 51 0 0 0 0 29 29 29 26 28 5 28 27 29 29
0 0 0 0 0 0 0 0 0 0 51 36 36 36 36 36 36 36 45 52 45 36 36 36 36 36 36 36 36 36 36 36 36 36 36 36 36 36 52 36 36 36 36 36 36 51 0 0 0 0 29 29 29 26 28 5 28 27 29 29
0 0 0 0 0 0 0 0 0 0 51 36 36 36 36 36 36 36 52 52 52 36 36 36 36 36 36 36 36 36 36 36 36 36 36 36 36 36 52 36 36 36 36 36 36 51 0 0 0 0 29 29 29 26 28 5 28 27 29 29
0 0 0 0 0 0 0 0 0 0 51 36 36 36 36 36 36 36 36 36 36 36 36 36 36 36 36 36 36 36 36 36 36 36 36 36 36 36 52 36 36 36 36 36 36 51 0 0 0 0 29 29 29 26 28 5 28 27 29 29
0 0 0 0 0 0 0 0 0 0 51 36 36 36 36 36 36 36 36 36 36 36 36 36 36 36 36 36 36 36 36 36 36 36 36 36 36 36 52 36 36 36 36 36 36 51 0 0 0 0 29 29 29 26 28 5 28 27 29 29
0 0 0 0 0 0 0 0 0 0 51 51 51 51 51 51 51 51 51 36 36 52 52 36 36 36 52 52 36 36 36 36 36 36 36 36 36 36 52 36 36 36 36 36 36 51 0 0 0 0 29 29 29 26 28 5 28 27 29 29
0 0 0 0 0 0 0 0 0 0 51 52 49 49 49 49 49 52 52 36 36 53 53 36 36 36 54 54 36 36 36 36 36 36 36 36 36 36 52 36 36 36 36 36 36 51 0 0 0 0 29 29 29 26 28 5 28 27 29 29
0 0 0 0 0 0 0 0 0 0 51 36 36 36 36 36 36 47 47 36 36 53 53 36 36 36 54 54 36 36 36 36 36 36 36 36 36 36 52 36 36 36 36 36 36 51 0 0 0 0 29 29 29 26 28 5 28 27 29 29
0 0 0 0 0 0 0 0 0 0 51 36 36 36 36 36 36 47 47 36 36 53 53 36 36 36 54 54 36 36 36 36 36 36 36 36 36 36 52 36 36 36 36 36 36 51 0 0 0 0 29 29 29 26 28 5 28 27 29 29
0 0 0 0 0 0 0 0 0 0 51 36 36 36 36 36 36 52 52 36 36 52 52 36 36 36 52 52 36 36 36 36 36 36 36 36 36 36 52 36 36 36 36 36 36 51 0 0 0 0 29 29 29 26 28 5 28 27 29 29
0 0 0 0 0 0 0 0 0 0 51 36 36 36 36 36 36 36 36 36 36 36 36 36 36 36 36 36 36 36 36 36 36 36 36 36 36 36 52 36 36 36 36 36 36 51 0 0 0 0 29 29 29 26 28 5 28 27 29 29
0 0 0 0 0 0 0 0 0 0 51 36 36 36 36 36 36 36 36 36 36 36 36 36 36 36 36 36 36 36 36 36 36 36 36 36 36 36 52 36 36 36 36 36 36 51 0 0 0 0 29 29 29 26 28 5 28 27 29 29
0 0 0 0 0 0 0 0 0 0 51 51 51 51 51 51 51 51 51 36 51 51 51 51 51 51 51 51 51 51 51 51 51 51 36 36 36 51 51 51 36 36 36 51 51 51 0 0 0 0 29 29 29 26 28 5 28 27 29 29
29 29 29 29 29 29 29 29 29 29 29 29 29 29 29 29 29 29 29 29 29 29 29 29 29 29 29 29 29 29 29 29 29 29 29 29 29 29 29 29 29 29 29 29 29 29 29 29 29 29 29 29 29 26 28 5 28 27 29 29
29 29 29 29 29 29 29 29 29 29 29 29 29 29 29 29 29 29 29 29 29 29 29 29 29 29 29 29 29 29 29 29 29 29 29 29 29 29 29 29 29 29 29 29 29 29 29 29 29 29 29 29 29 26 28 5 28 27 29 29
31 31 31 31 31 31 31 31 31 31 31 31 31 31 31 31 31 31 31 31 31 31 31 31 31 31 31 31 31 31 31 31 31 31 31 31 31 31 31 31 31 31 31 31 31 31 31 31 31 31 31 31 31 28 28 5 28 27 29 29
28 28 28 28 28 28 28 28 28 28 28 28 28 28 28 28 28 28 28 28 28 28 28 28 28 28 28 28 28 28 28 28 28 28 28 28 28 28 28 28 28 28 28 28 28 28 28 28 28 28 28 28 28 28 28 5 28 27 29 29
30 30 30 30 30 30 30 30 30 30 30 30 30 30 30 30 30 30 30 30 30 30 30 30 30 30 30 30 30 30 30 30 30 30 30 30 30 30 30 30 30 30 30 30 30 30 30 30 30 30 30 30 30 28 28 5 28 27 29 29
28 28 28 28 28 28 28 28 28 28 28 28 28 28 28 28 28 28 28 28 28 28 28 28 28 28 28 28 28 28 28 28 28 28 28 28 28 28 28 28 28 28 28 28 28 28 28 28 28 28 28 28 28 28 28 5 28 27 29 29
32 32 32 32 32 32 32 32 32 32 32 32 32 32 32 32 32 32 32 32 32 32 32 32 32 32 32 32 32 32 32 32 32 32 32 32 32 32 32 32 32 32 32 32 32 32 32 32 32 32 32 32 32 28 28 5 28 27 29 29
29 29 29 29 29 29 29 29 29 29 29 29 29 29 29 29 29 29 29 29 29 29 29 29 29 29 29 29 29 29 29 29 29 29 29 29 29 29 29 29 29 29 29 29 29 29 29 29 29 29 29 29 29 26 28 5 28 27 29 29
29 29 29 29 29 29 29 29 29 29 29 29 29 29 29 29 29 29 29 29 29 29 29 29 29 29 29 29 29 29 29 29 29 29 29 29 29 29 29 29 29 29 29 29 29 29 29 29 29 29 29 29 29 26 28 5 28 27 29 29
0 0 0 0 0 0 0 0 0 0 0 0 0 0 0 0 0 0 0 0 0 0 0 0 0 0 0 0 0 0 0 0 0 0 0 0 0 0 0 0 0 0 0 0 0 0 0 0 0 0 29 29 29 26 28 5 28 27 29 29
0 0 0 0 0 0 0 0 0 0 0 0 0 0 0 0 0 0 0 0 0 0 0 0 0 0 0 0 0 0 0 0 0 0 0 0 0 0 0 0 0 0 0 0 0 0 0 0 0 0 29 29 29 26 28 5 28 27 29 29